00000110000001100000
00000101000010100000
00000010000001000000
00000000010000000000
00000000010000000000
00000000010000000000
00000000000000000110
00000000000000000110
00010000000000000000
00100100000000000000
00100100000011000000
00001000000011000000
00000000000000000000
